┌──────────────────────────────────────────┐
│                                          │
│                                          │
│                                          │
│                                          │
│                                          │
│                                          │
│                                          │
│                                          │
│                                          │
│                                          │
│                                          │
└──────────────────────────────────────────┘