┌───────────────────────────────┐
│                               │
│                               │
│                               │
│                               │
│                               │
│                               │
│                               │
│                               │
│                               │
│                               │
│                               │
└───────────────────────────────┘