┌───────────────────────────────┐
│                               │
│                               │
│                               │
│                               │
│                               │
│             X                 │
│                               │
│                               │
│                               │
│                               │
│                               │
└───────────────────────────────┘