┌───────────────────────────────┐
│                               │
│                               │
│                               │
│                               │
│                               │
│                          X    │
│                               │
│                               │
│                               │
│                               │
│                               │
└───────────────────────────────┘